1111111111111111111111111111111111111111111111111111111111111
1E0000000000000C000000000P0000000C000000000000000000011111111
1010111111111010101111111110101111111010101111111110101111111
1010000000001010100000000010100000001010100000000010101111111
1010111111111010101111111010101111111010101111111100101111111
10100C0C0C0001010100C0C0C0010100C0C0C0010100C0C0C001010111111
1111111111111111111111111111111111111111111111111111111111111